1111111111111111111111111111111111
1110000000000000000000000000000001
1E00101001000001010010000000101001
1110010010101010001001000000010101
1PC000000000000C000000000000000001
1111111111111111111111111111111111